

|---------------|-------------|
|               |             |
|               |             |
|  A pink room      A hall    |
|               |             |
|               |             |
|------  -------|------  -----|
|               |             |
|               |             |
|      The           A dark   |
|    Entrance   |     cave    |
|               |             |
|---------------|-------------|